+-+-+-+-+-+-+-+-+-+-+-+-+-+-+-+-+-+-+-+-+
|     | |     | |         |     |     | |
+ + +-+ + +-+ + + + + +-+ + + + + +-+ + +
| | | | | | |   | | | |     | |     |   |
+ +-+ + + + +-+ + + + + + + + +-+-+-+-+ +
|     | | |       | | | | | |     |     |
+ + + + + + +-+-+-+ + + +-+-+-+ +-+-+-+ +
| | |     | |       | | | | | | |     | |
+ +-+-+-+ +-+-+-+-+ +-+ + + + +-+ + +-+-+
|   |   | |   | |     |   |       |   | |
+ + + +-+-+ + + + + +-+-+ + + +-+-+ + + +
| |   |     |   | | |   | | | |     |   |
+ +-+-+ + + + +-+ + + + + + +-+ +-+-+-+-+
| |     | | |   | | | |   |   |     | | |
+ + +-+-+ +-+-+ + + +-+ + + +-+-+-+-+ + +
| |     | | |   | |   | | |   | |   | | |
+ + + +-+ + + + +-+-+-+ + + + + + +-+ + +
| | |   | | | |         |   |   |       |
+ + +-+-+-+ + +-+ +-+ + + +-+ +-+ +-+-+-+
| | | |     | | |   | | |   |   | | |   |
+ + + + +-+ +-+ +-+ + +-+-+-+-+-+ + + + +
| | |     |         | |     |   |   | | |
+ + + +-+-+-+ +-+ + + + + + + +-+ + + + +
| | |   |       | | | | | |       | | | |
+ + +-+ + +-+ +-+ +-+ + +-+-+ + + +-+ +-+
| | | | |   |   | |   |   | | | |   | | |
+ + + +-+-+-+ + +-+-+-+ + + + + + + + + +
| |     | | | |   |   | | | | | | |   | |
+ + + + + + + +-+-+ + + +-+ + +-+-+-+-+ +
| | | | |           |     | | |     | | |
+ + + +-+-+-+ +-+-+ + + +-+ +-+ +-+ + + +
| | | |   | | |     | |   |   |   |   | |
+ + + + +-+ + +-+-+ + +-+-+ + + + +-+ + +
| | | |   |       | |   |   |   | |   | |
+ + +-+ +-+ + +-+-+-+ +-+ + + +-+-+ + + +
| |   |   | | | | |     | | |     | | | |
+ +-+-+ +-+-+ + + +-+-+ + + +-+-+-+ + + +
|   | |   |   |     |   | | | | |   |   |
+ +-+ + +-+ +-+ +-+-+ +-+ + + + +-+ +-+ +
| |                 |     |       |   | |
+-+-+-+-+-+-+-+-+-+-+-+-+-+-+-+-+-+-+-+-+
