+-+-+-+-+-+-+-+-+-+-+
|     | |     |   | |
+ + +-+ + + +-+ +-+ +
| | | | | |         |
+ + + + + + + +-+-+-+
| |     | | | | | | |
+ +-+ + + + +-+ + + +
| |   |   |   |   | |
+ + +-+ +-+-+ + + + +
| |   |   | | | | | |
+ +-+ +-+ + +-+ +-+ +
| | | | | | | | |   |
+ + +-+ +-+ + + + +-+
| | |     | | |   | |
+ + + + + + + + +-+ +
|     | | |     | | |
+ + +-+-+ + + +-+ + +
| | | | | | | | |   |
+ +-+ + + + + + + +-+
|     |     |       |
+-+-+-+-+-+-+-+-+-+-+
